Slow Productivity The Lost Art of Accomplishment Without Burnout - Cal Newport
The Balanced Brain - Camilla Nord
Reinvent Yourself - Susan Kahn
The Life Brief: A Playbook for No-Regrets Living - Bonnie Wan
Fluke Chance Chaos and Why Everything We Do Matters - Brian Klaas
Uncommon Sense Teaching Practical Insights in Brain Science to Help Students Learn
The Amen Effect Ancient Wisdom to Mend Our Broken Hearts and World - Sharon Brous
Mixed Signals - Uri Gneezy
The Phone Fix - Dr Faye Begeti
Mastery - The Keys To Success And Long-Term Fulfillment - George Leonard
Supercommunicators: How to Unlock the Secret Language of Connection - Charles Duhigg
Optimal - Daniel Goleman
Ultralearning Master Hard Skills Outsmart the Competition and Accelerate Your Career
Your Pocket Therapist - Dr. Annie Zimmerman
The 5 Resets - Dr. Aditi Nerurkar M.D.
Art Of Focus - Dan Koe
48 Laws of Power - Robert Greene
Dopamine Nation: Finding Balance in the Age of Indulgence - Anna Lembke
Same as Ever: A Guide to What Never Changes - Morgan Housel
The Art Of Focus - Dan Koe
Self-Talk for a Calmer You - Beverly Flaxington
100M Offers How to Make Offers So Good People Feel Stupid Saying No - Alex Hormozi
Feel-Good Productivity: How to Do More of What Matters to You - Ali Abdaal
Abundance - The Inner Path to Wealth - Deepak Chopra
Power: Why Some People Have It—and Others Don't- Jeffrey Pfeffer
Hook Point: How to Stand Out in a 3-Second World - Brendan Kane
Real Self-Care - Pooja Lakshmin MD
Understanding How We Learn - Yana Weinstein
Quiet: The Power of Introverts in a World That Can't Stop Talking - Susan Cain
Give and Take: A Revolutionary Approach to Success - Adam Grant
Awaken Your Genius by Ozan Varol
The Daily Laws: 366 Meditations - Robert Greene
The Hard Thing About Hard Things - Ben Horowitz
The Introvert's Way - Sophia Dembling
Think Big: Take Small Steps and Build the Career You Want - Grace Lordan
Mindfulness for Dummies - Shamash Alidina
48-Hour Start-Up: From Idea to Launch in 1 Weekend by Fraser Doherty
What You Do Is Who You Are: How to Create Your Business Culture - Ben Horowitz
The Millionaire Next Door: The Surprising Secrets of America's Rich - Thomas Stanley
The Thank You Economy - Gary Vaynerchuk
Willpower Doesn't Work - Benjamin Hardy
To Sell Is Human: The Surprising Truth about Moving Others by Daniel H. Pink
If You're So Smart, Why Aren't You Happy - Raj Raghunathan
Focus - The Hidden Driver of Excellence by Daniel Goleman
Effortless - Make It Easier to Do What Matt by Greg McKeown
The Effective Executive - Peter F. Drucker
Grit: The Power of Passion and Perseverance Paperback by Angela Duckworth
Drive: The Surprising Truth About What Motivates Us Paperback by Daniel H. Pink
Choose Yourself! - James Altucher
Abundance: The Future Is Better Than You Think - Peter H. Diamandis
Onward: How Starbucks Fought for Its Life without Losing Its Soul - Howard Schultz
Win Every Argument: The Art of Debating, Persuading, and Public Speaking - Mehdi Hasan
Originals - How Non-Conformists Move the World - Adam Grant
The Everything Store: Jeff Bezos and the Age of Amazon - Brad Stone
Spare - Prince Harry, The Duke of Sussex
Loserthink: How Untrained Brains Are Ruining America- Scott Adams
How Adam Smith Can Change Your Life - Russ Roberts
Way of the Wolf - Jordan Belfort
Spiritual Activator - Oliver Nino
Soul Boom: Why We Need a Spiritual Revolution - Rainn Wilson
The Surrender Experiment - Michael A. Singer - NEW NARRATOR
Verbal Judo - The Gentle Art of Persuasion - George J. Thompson
How to Fail at Almost Everything and Still Win Big - Scott Adams
Shoe Dog - A Memoir by the Creator of Nike - Phil Knight
How to Change - Katy Milkman
Keep Going - Austin Kleon
Show Your Work! - Austin Kleon
Steal Like an Artist - Austin Kleon
Habits of a Happy Brain - Loretta Graziano Breuning
Can't Hurt Me Master Your Mind and Defy the Odds
10% Happier - Dan Harris
Solve for Happy - Mo Gawdat
Love Yourself Like Your Life Depends On It - Kamal Ravikant
The Power of No - James Altucher
The Little Book of Hygge - Danish Secrets to Happy Living - Meik Wiking
Don't Sweat the Small Stuff And It's All - Richard Carlson
Side Hustle - Chris Guillebeau
Big Magic - Creative Living Beyond Fear - Elizabeth Gilbert
Emotions - Osho
Girl, Wash Your Face - Rachel Hollis
Find Your Why - Simon Sinek
The Power of Regret - How Looking Backward Moves Us Forward Daniel H. Pink
The Comfort Book - Matt Haig
Five Love Languages Singles Edition - Gary D. Chapman
The Life Changing Magic of Tidying Up - Marie Kondo
The Gifts of Imperfection - Brene Brown
Who Moved My Cheese - An Amazing Way to Deal Wealth Management - Spencer Johnson
The Obstacle Is the Way - The Timeless Art of Turning Trials into Triumph - Ryan Holiday
Resilient - How to Grow an Unshakable Core of Calm, Strength, and Happiness - Rick Hanson
How to attract money - Joseph Murphy
52 Weekly Affirmations - Joseph Murphy
You Are the Placebo Making Your Mind Matter - Joe Dispenza
Believe It to Achieve It - Brian Tracy
Discipline Is Destiny - The Power of Self Control - Ryan Holiday
Courage Is Calling Fortune Favors the Brave - Ryan Holiday
The Body Keeps the Score - Bessel Van Der Kolk M.D.
The Emotion Code - Dr. Bradley Nelson
Stolen Focus - Why You Can't Pay Attention—and How to Think Deeply Again - Johann Hari
It Goes So Fast The Year of No Do Overs - Mary Louise Kelly
Make Your Bed -William H. McRaven
Good Vibes, Good Life How Self Love Is the Key to Unlocking Your Greatness - Vex King
Nonviolent Communication A Language of Life - Marshall Rosenberg
The Psychology of Money - Timeless Lessons on Wealth, Greed, and Happiness - Morgan Housel
Ikigai: The Japanese Secret to a Long and Happy Life - Hector Garcia
Building a Second Brain - Tiago Forte
The Bed of Procrustes - Nassim Nicholas Taleb
The Miracles of Your Mind - Joseph Murphy
I Will Teach You to Be Rich - Ramit Sethi
Stop Overthinking - Nick Trenton
Zero to One - Peter Thiel
The 7 Habits of Highly Effective People - Stephen R. Covey
Deep Work: Rules for Focused Success - Cal Newport
Why Has Nobody Told Me This Before - Dr Julie Smith
Nudge - Improving Decisions About Health, Wealth, and Happiness - Richard H. Thaler, Cass R. Sunstein
Never Split the Difference - Chris Voss
The Light We Carry - Michelle Obama
A New Earth - Awakening to Your Life's Purpose - Eckhart Tolle
How to Win Friends and Influence People - Dale Carnegie
The Mastery of Love - A Practical Guide to the Art of Relationship - Don Miguel Ruiz
So Good They Can't Ignore You - Cal Newport
Think and Grow Rich! - Napoleon Hill
The Richest Man In Babylon - George S Clason
Rich Dad Poor Dad - Robert Kiyosaki
The Lean Startup - Eric Ries
Skin in the Game - Nassim Nicholas Taleb
The Power of Now - Eckhart Tolle
Antifragile - Things That Gain from Disorder - Nassim Taleb
Mind to Matter - Dawson Church
Hooked - Nir Eyal
The Untethered Soul - Jefferson A Singer
Breaking the Habit of Being Yourself - Joe Dispenza
The Four Agreements - Don Miguel Ruiz
The Power of Your Subconscious Mind - Joseph Murphy
The Alchemist - Paulo Coelho
Secrets of the Millionaire Mind - T. Harv Eker
The 5AM Club - Own Your Morning Elevate Your Life - Robin Sharma
4 Hour Workweek - Timothy Ferriss
Outlive - The Science and Art of Longevity - Peter Attia, MD
Psycho Cybernetics, Updated and Expanded - Maxwell Maltz
UNSCRIPTED - The Great Rat Race Escape - MJ DeMarco
Atomic Habits - An Easy & Proven Way to Build Good Habits & Break Bad Ones - James Clear
The Power of Experiments: Decision Making in a Data-Driven World - Michael Luca
The Courage to Be Disliked - Ichiro Kishimi
The Almanack of Naval Ravikant - Eric Jorgenson